####################
#..................#
#..L......#.L......#
#........#.#.......#
........#.W.#.......
.......#######......
#.....#.......#....#
#....#.....L...#...#
#..................#
#######...##########