######..############
#..................#
#...###########....#
#...#.........L....#
....#..L...........#
....#.....L........#
#...#..............#
#...###########....#
#..................#
#######..###########