#########..#########
#..................#
#...#####......L...#
#.L.#...#..........#
#...#..#........#...
#...####........#...
#...#..#....L...####
#...#W..#..........#
#...#####..........#
####################