####################
#..................#
#..................#
#..........L...L...#
.............L.....#
........L........L.#
#...........L..W####
#...............####
#.............L....#
####################